111111111111111111
1P0000000000000001
101000011110111101
101000010000100101
101000011100100101
101000010000100101
101111011110111101
100000000000000001
101111011110100101
101000010010010101
101011011110001001
101001010010010001
101111010010100C01
100000000000000E01
111111111111111111
